---#--###--#-
-#---#----##-
####-#-#-#-##
---#---#-#---
-#-####---##-
-#------#---#
-############
------------@